R 848 480
NO textures/wall_1.xpm
SO textures/wall_2.xpm
WE textures/wall_3.xpm
EA textures/wall_4.xpm
S ./path_to_the_sprite_texture
F 184,113,39
C 51,198,227

111111111111111
100000000000001
100000000111111
1000000001
1000000001
100000000111111
100000000000001
111111100000001
      100000001
      100000001
      100000001
      100000001
111111100000001
10000000000N001
100000000000001
111111111111111