NO ./tex/wall4.xpm
SO ./tex/wall4.xpm
WE ./tex/wall4.xpm
EA ./tex/wall4.xpm
F 184,113,39
C 51,198,227

1111 1111111111
100111000000001
100000000111111
1000000001
1000000001
100000000111111
100000000000001
1111111000000011111111111111111111111111
      1000000000000000100000001000000001
      1000000S00000000000000000000000001
      1000000000000000000000000000000001
      1000111000000000000000000000000001
11111110001 1000000000000000000100000001
1000000001111110000000000000000100000001
1000000111000110000000000010000100000001
11111111 1111111111111111111111111111111
