NO ./tex/wall.xpm
SO ./tex/wall.xpm
WE ./tex/wood.xpm
EA ./tex/wood.xpm
F 184,113,39
C 51,198,227

1111 1111111111
100111000000001
100000000111111
1000000001
1000000001
100000000111111
100000000000001
11111110000000111111111111111111111111111111111
      10000000000000001000000010000000000000001
      10000000000000000000000000000000000000001
      10000000000000000000000000000000000000001
      10001110000000000000000000000000000000001
11111110001 10000000000000000000000000100000001
10000000001110100000000000000000000000100000001
1000000111000110000000000N000010000000100000001
11111111 11111111111111111111111111111111111111
