NO ./tex/aer.xpm
SO ./tex/terra.xpm
WE ./tex/fire.xpm
EA ./tex/aqua.xpm

F 255,255,255
C 100,100,100

1111 1111111111
100111000000001
100000000111111
1000000001
1000000001
100000000111111
100000000000001
1111111000000011111111111111111111111111
      1000000000000000100000001000000001
      1000000000000000000000000000000001
      1000000000000000000000000000000001
      1000111000000000000000000000000001
11111110001 1000000000S00000010000000011
1000000001111000000000000000000100000001
1000000111000000000000000010000100000001
11111111 1111111111111111111111111111111
