NO textures/wall_1.xpm
SO textures/wall_2.xpm
WE textures/wall_3.xpm
EA textures/wall_4.xpm
F 184,113,39
C 51,198,227

1111 1111111111
100111000000001
100000000111111
1000000001
1000000001
100000000111111
100000000000001
111111100000001
      100000001
      100000001
      100000001
      100011101
11111110001 101
10000N000011101
100000011100011
11111111 111111