NO ./tex/wall.xpm
SO ./tex/wall.xpm
WE ./tex/wood.xpm
EA ./tex/wood.xpm
F 184,113,39
C 51,198,227

1111111111111
1000000000001
1000000000001
1000000000001
10000000N0001
1111111111111
